Dall'	PRE:det
epistolario	NOM
si	PRO:refl
evince	VER:pres
l'	DET:def
autonomia	NOM
di	PRE
giudizio	NOM
di	PRE
Frontone	NOM
,	PON
testimoniata	VER:pper
dagli	PRE:det
atteggiamenti	NOM
da	PRE
lui	PRO:pers
assunti	VER:pper
sul	PRE:det
problema	NOM
politico-morale	ADJ
suscitato	VER:pper
dai	PRE:det
testamenti	NOM
di	PRE
Nigro	NOM
Censorio	NOM
e	CON
di	PRE
Matidia	NOM
e	CON
nel	PRE:det
processo	NOM
contro	PRE
Erode	NOM
Attico	NOM

