Die	ART
Erstpublikation	NN
einer	ART
lateinischen	ADJA
Grabinschrift	NN
etwa	ADV
aus	APPR
claudischer	ADJA
Zeit	NN
(	$(
gefunden	VVPP
Ende	NN
der	ART
70er	ADJA
Jahre	NN
im	APPRART
Abraum	NN
aus	APPR
dem	ART
Turm	NN
des	ART
Doms	NN
von	APPR
Avellino	NE
)	$(
gibt	VVFIN
Anlass	NN
zu	APPR
Überlegungen	NN
zur	APPRART
Geschichte	NN
der	ART
«	$(
ala	ADJA
Moesica	NE
»	$(
und	KON
ihrer	PPOSAT
Präfekten	NN
.	$.

