Africanus	NN
'	POS
«	)
Kestoi	NP
»	(
seem	VB
devoid	JJ
of	IN
any	DT
distinctively	RB
Christian	JJ
content	NN
.	SENT

They	PP
must	MD
be	VB
situated	VBN
instead	RB
in	IN
the	DT
context	NN
of	IN
broader	JJR
cultural	JJ
and	CC
political	JJ
trends	NNS
in	IN
the	DT
Romanization	NN
of	IN
the	DT
Greek-speaking	NP
elites	NNS
in	IN
the	DT
Near	NP
East	NP
of	IN
the	DT
late	JJ
2nd	JJ
and	CC
early	JJ
3rd	JJ
cents	NNS
.	SENT

