Kommentierte	ADJA
Neuedition	NN
des	ART
Textes	NN
,	$,
der	ART
verschiedene	ADJA
hohe	ADJA
Ämter	NN
erwähnt	VVPP
und	KON
dessen	PDAT
Verständnis	NN
durch	APPR
den	ART
Verlust	NN
von	APPR
mehr	ADV
als	KOKOM
der	ART
Hälfte	NN
des	ART
Papyrus	NN
auf	APPR
der	ART
rechten	ADJA
Seite	NN
stark	ADJD
eingeschränkt	VVPP
ist	VAFIN

