Die	ART
Inschrift	NN
des	ART
hier	ADV
publizierten	ADJA
Altärchens	NN
(	$(
Privatbesitz	NN
)	$(
ist	VAFIN
wegen	APPR
des	ART
folgenden	ADJA
Namens	NN
mit	APPR
der	ART
Formel	NN
V°S°L°	NE
nicht	PTKNEG
als	KOKOM
D(is	NN
)	$(
M(anibus	NN
)	$(
sacr(um	NE
)	$(
aufzulösen	VVIZU
,	$,
sondern	KON
den	ART
zahlreichen	ADJA
Weihungen	NN
für	APPR
Mithras	NN
zuzuordnen	VVIZU
,	$,
die	PRELS
in	APPR
Carnuntum	NN
allerdings	ADV
meist	ADV
D(eo	NE
)	$(
I(nvicto	NE
)	$(
M(ithrae	NE
)	$(
lauten	VVFIN
.	$.

Der	ART
Stifter	NN
,	$,
Lucius	NE
Cassius	NE
Florentinus	NE
ist	VAFIN
zusammen	ADV
mit	APPR
seinen	PPOSAT
«	$(
officia	NE
militaria	NE
»	$(
auch	ADV
in	APPR
CIL	NN
3	CARD
,	$,
11189	CARD
(	$(
235-238	CARD
n.	APPR
Chr.	NE
)	$(
genannt	VVPP

