Las	ART
fuentes	NC
griegas	ADJ
literarias	ADJ
e	CC
iconográficas	NC
evidencian	VLfin
que	CQUE
en	PREP
la	ART
Antigüedad	NC
hubo	VHfin
distintas	ADJ
versiones	NC
del	PDEL
mito	NC
de	PREP
Meleagro	NC
,	CM
difícilmente	ADV
conciliables	ADJ
entre	PREP
sí	PPX
.	FS

Se	SE
repasan	VLfin
las	ART
diversas	QU
interpretaciones	NC
que	CQUE
del	PDEL
mito	NC
han	VHfin
propuesto	VLadj
los	ART
eruditos	NC
modernos	ADJ
,	CM
destacándose	VLadj
tanto	ADV
los	ART
aciertos	NC
como	CSUBX
algunas	QU
lecturas	NC
excesivamente	ADV
parciales	ADJ
o	CC
sesgadas	VLadj

