Die	ART
Verwechslung	NN
der	ART
Verwandtschaftsbezeichnungen	NN
der	ART
Götter	NN
ist	VAFIN
weniger	ADV
eine	ART
Kritik	NN
an	APPR
römischer	ADJA
Gebetssprache	NN
als	KOKOM
an	APPR
demjenigen	PDS
,	$,
der	PRELS
erfolglos	ADJD
versucht	VVPP
,	$,
sie	PPER
zu	PTKZU
verwenden	VVINF
.	$.

Sie	PPER
reflektiert	VVFIN
daneben	PAV
die	ART
an	APPR
mehreren	PIAT
Stellen	NN
des	ART
Stücks	NN
zu	APPR
beobachtende	ADJA
Verwirrung	NN
des	ART
Alcesimarchus	NN
und	KON
durch	APPR
die	ART
Auswahl	NN
der	ART
Gottheiten	NN
ein	ART
wichtiges	ADJA
Thema	NN
der	ART
«	$(
Cistellaria	NE
»	$(
,	$,
nämlich	ADV
die	ART
Unterscheidung	NN
zwischen	APPR
«	$(
matronae	NE
»	$(
und	KON
«	$(
meretrices	VVFIN
»	$(
.	$.

