Eine	ART
Untersuchung	NN
des	ART
Buchstaben-Typus	NN
der	ART
«	$(
Grossen	ADJA
Spenderliste	NN
»	$(
und	KON
sieben	CARD
weiterer	ADJA
ephesischer	ADJA
Inschriften	NN
zeigt	VVFIN
,	$,
dass	KOUS
die	ART
Charakteristika	NN
einerseits	ADV
im	APPRART
besonderen	ADJA
Schwung	NN
der	ART
Linien	NN
und	KON
der	ART
Zierstriche	NN
,	$,
andererseits	ADV
in	APPR
der	ART
von	APPR
der	ART
Norm	NN
abweichenden	ADJA
Grösse	NN
einzelner	ADJA
Buchstaben	NN
,	$,
die	PRELS
vom	APPRART
Schreiber	NN
konsequent	ADJD
eingehalten	VVPP
wird	VAFIN
,	$,
liegen	VVFIN
.	$.

Infolge	APPR
dieser	PDAT
Eigenheiten	NN
ist	VAFIN
es	PPER
möglich	ADJD
,	$,
alle	PIAT
Inschriften	NN
einem	ART
einzigen	ADJA
Schreiber	NN
zuzuweisen	VVIZU
,	$,
der	PRELS
in	APPR
der	ART
Regierungszeit	NN
des	ART
Tiberius	NE
gearbeitet	VVPP
hat	VAFIN
.	$.

Anhang	NN
:	$.
Zur	APPRART
Familie	NN
des	ART
in	APPR
mehreren	PIAT
Inschriften	NN
genannten	ADJA
T.	NE
Fl.	NE
Pythion	NN
.	$.

