Die	ART
in	APPR
der	ART
Gegend	NN
von	APPR
Babylon	NE
gefundenen	ADJA
Münzen	NN
der	ART
sogenannten	ADJA
«	$(
Poros	NN
»-Prägung	NN
könnten	VMFIN
in	APPR
der	ART
Spätzeit	NN
Alexanders	NE
in	APPR
Mesopotamien	NN
entstanden	VVPP
sein	VAINF
.	$.

Die	ART
ursprünglich	ADJD
wahrscheinlich	ADJD
gross	ADJD
angelegte	ADJA
Emission	NN
endete	VVFIN
vermutlich	ADV
mit	APPR
dem	ART
Tod	NN
Alexanders	NE
,	$,
und	KON
seine	PPOSAT
Nachfolger	NN
kehrten	VVFIN
wieder	ADV
zu	APPR
einem	ART
«	$(
rein	ADV
griechischen	ADJA
»	$(
Alexanderbild	NN
zurück	PTKVZ
.	$.

