Der	ART
hallenumsäumte	ADJA
Platz	NN
des	ART
literarisch	ADJD
als	KOKOM
Asyl	NN
bezeugten	ADJA
Heiligtums	NN
ist	VAFIN
als	KOKOM
Festwiese	NN
zu	PTKZU
deuten	VVINF
;	$.
die	ART
zwischen	APPR
dem	ART
ausgehenden	ADJA
5.	ADJA

Jh	NE
.	$.
und	KON
der	ART
Mitte	NN
des	ART
4.	ADJA

Jh	NE
.	$.

v.	APPR
Chr.	NE
errichteten	ADJA
Hallen	NN
dienten	VVFIN
als	KOKOM
Zufluchtstätten	NN
für	APPR
Asylsuchende	NN
.	$.

Der	ART
Ort	NN
war	VAFIN
durch	APPR
seine	PPOSAT
Lage	NN
abseits	APPR
der	ART
Konfliktzentren	NN
,	$,
aber	ADV
nicht	PTKNEG
völlig	ADJD
vom	APPRART
Informationsfluss	NN
abgeschnitten	VVPP
,	$,
sowohl	KON
für	APPR
die	ART
(	$(
privilegierten	ADJA
)	$(
Schutzflehenden	NN
als	KOKOM
auch	ADV
für	APPR
ihre	PPOSAT
Verfolger	NN
akzeptabel	ADJD
.	$.

