Le	DET:def
note	NOM
metodologiche	ADJ
indicano	VER:pres
la	DET:def
volontà	NOM
di	PRE
definire	VER:infi
una	DET:indef
nuova	ADJ
forma	NOM
esegetica	ADJ
rispetto	NOM
alla	PRE:det
tradizione	NOM
del	PRE:det
commento	NOM
greco	ADJ
e	CON
latino	ADJ
,	PON
ad	PRE
esempio	NOM
concentrandosi	VER:geru
sugli	PRE:det
«	PON
obscura	NOM
»	PON
del	PRE:det
testo	NOM
tramite	PRE
una	DET:indef
metodologia	NOM
zetetica	ADJ

