Bei	APPR
den	ART
Surveys	NN
in	APPR
der	ART
Region	NN
Paphos	NN
wurden	VAFIN
21	CARD
Fundstätten	NN
vom	APPRART
Chalkolithikum	NN
bis	KON
in	APPR
die	ART
Neuzeit	NN
entdeckt	VVPP
,	$,
darunter	PAV
drei	CARD
Friedhöfe	NN
,	$,
die	PRELS
von	APPR
der	ART
frühkyprischen	ADJA
bis	KON
in	APPR
die	ART
römische	ADJA
Zeit	NN
belegt	VVPP
waren	VAFIN
.	$.

Dort	ADV
wurde	VAFIN
auch	ADV
kypro-klassische	ADJA
und	KON
hellenistische	ADJA
Keramik	NN
gefunden	VVPP
,	$,
was	PRELS
ansonsten	ADV
in	APPR
der	ART
Gegend	NN
selten	ADJD
ist	VAFIN
,	$,
da	KOUS
Marion	NE
in	APPR
dieser	PDAT
Zeit	NN
zweimal	ADV
zerstört	VVPP
wurde	VAFIN
.	$.

Fundkatalog	NN

