Given	VBN
the	DT
distinction	NN
between	IN
proverbs	NNS
used	VBN
as	IN
an	DT
integral	JJ
part	NN
of	IN
Strabo	NP
's	POS
own	JJ
style	NN
of	IN
writing	NN
and	CC
those	DT
applied	VBN
as	IN
grammatically	RB
independent	JJ
expressions	NNS
in	IN
their	PP$
role	NN
as	IN
proverbs	NNS
,	,
discusses	VBZ
the	DT
latter	JJ
kind	NN
.	SENT

Several	JJ
previously	RB
unnoticed	JJ
proverbs	NNS
and	CC
proverbial	JJ
expressions	NNS
are	VBP
included	VBN
,	,
and	CC
the	DT
phenomenon	NN
is	VBZ
discussed	VBN
from	IN
a	DT
new	JJ
point	NN
of	IN
departure	NN
.	SENT

By	IN
defining	VBG
these	DT
expressions	NNS
as	RB
«	)
geographical	JJ
proverbs	NNS
»	(
,	,
always	RB
accompanied	VBN
by	IN
explanatory	JJ
stories	NNS
,	,
insights	NNS
are	VBP
provided	VBN
into	IN
Strabo	NP
's	POS
choice	NN
of	IN
themes	NNS
which	WDT
results	NNS
in	IN
his	PP$
overall	JJ
geographical	JJ
narrative	NN

