Se	SE
analizan	VLfin
las	ART
distintas	ADJ
ciudades	NC
del	PDEL
sur	PE
de	PREP
la	ART
Península	NC
Ibérica	NP
citadas	VLadj
por	PREP
Estrabón	NP
,	CM
especialmente	ADV
aquellas	DM
que	CQUE
reciben	VLfin
de	PREP
forma	NC
clara	ADJ
apelativos	NC
como	CSUBX
«	SYM
metrópolis	NC
»	SYM
o	ALFS
«	SYM
polis	NC
»	SYM
que	CQUE
les	PPC
confieren	VLfin
unas	ART
características	NC
distintivas	ADJ
respecto	NC
a	PREP
las	ART
demás	QU
.	FS

Con	PREP
ayuda	NC
del	PDEL
conocimiento	NC
que	CQUE
tenemos	VLfin
de	PREP
las	ART
ideas	NC
geográficas	ADJ
de	PREP
Estrabón	NC
gracias a	PREP
los	ART
prolegómenos	NC
de	PREP
su	PPO
obra	NC
,	CM
se	SE
intenta	VLfin
averiguar	VLinf
si	CSUBX
dichas	QU
ideas	NC
fueron	VSfin
aplicadas	VLadj
a	PREP
esta	DM
región	NC
de	PREP
modo	NC
coherente	ADJ
por	PREP
el	ART
autor	NC
al	CSUBI
tratar	VLinf
el	ART
tema	NC
del	PDEL
urbanismo	NC

