Le	DET:def
due	ADJ
raccolte	NOM
,	PON
pur	ADV
nella	PRE:det
diversità	NOM
dei	PRE:det
contesti	NOM
e	CON
delle	PRE:det
modalità	NOM
,	PON
mirano	VER:pres
a	PRE
uno	DET:indef
stesso	ADJ
risultato	NOM
:	PON
trasmettere	VER:infi
attraverso	PRE
una	DET:indef
singola	ADJ
sezione	NOM
di	PRE
testo	NOM
,	PON
che	PRO:rela
si	PRO:refl
presupponeva	VER:impf
non	ADV
letto	VER:pper
per	PRE
intero	ADJ
,	PON
tutte	ADJ
le	DET:def
informazioni	NOM
necessarie	ADJ
alla	PRE:det
conoscenza	NOM
del	PRE:det
santuario	NOM
e	CON
dell'	PRE:det
esperienza	NOM
da	PRE
compiere	VER:infi

