Testo	NOM
,	PON
apparato	NOM
ed	CON
esame	NOM
puntuale	ADJ
dell'	PRE:det
epigramma	NOM
inciso	VER:pper
sulla	PRE:det
cd	NOM
.	SENT

«	PON
Porta	NOM
della	PRE:det
Concordia	NOM
immortale	ADJ
»	PON
nel	PRE:det
demo	VER:infi
di	PRE
Maratona	NOM
,	PON
composto	VER:pper
alla	PRE:det
morte	NOM
di	PRE
Annia	NOM
Regilla	NOM
,	PON
con	PRE
ogni	ADJ
verosimiglianza	NOM
dallo	PRE:det
stesso	ADJ
Erode	NOM
Attico	NOM

