Il	DET:def
tentativo	NOM
di	PRE
Dionigi	NOM
di	PRE
ricondurre	VER:infi
vari	ADJ
aspetti	NOM
della	PRE:det
civilt√†	NOM
romana	ADJ
a	PRE
un'	DET:indef
origine	NOM
greca	ADJ
era	VER:impf
un'	DET:indef
operazione	NOM
ardua	ADJ
e	CON
complessa	ADJ
,	PON
e	CON
Dionigi	NOM
stesso	ADJ
ne	ADV
era	VER:impf
perfettamente	ADV
consapevole	ADJ

