Ciceros	NE
Aussage	NN
,	$,
dass	KOUS
er	PPER
mit	APPR
seinen	PPOSAT
philosophischen	ADJA
Schriften	NN
den	ART
Dienst	NN
an	APPR
der	ART
«	$(
res	ADJA
publica	NE
»	$(
fortsetzen	VVINF
will	VMFIN
,	$,
sollte	VMFIN
ernstgenommen	VVPP
und	KON
es	PPER
sollte	VMFIN
davon	PAV
ausgegangen	VVPP
werden	VAINF
,	$,
dass	KOUS
seine	PPOSAT
Übertragung	NN
der	ART
griechischen	ADJA
Philosophie	NN
ins	APPRART
Lateinische	NN
zum	APPRART
Kampf	NN
für	APPR
die	ART
alte	ADJA
«	$(
res	ADJA
publica	NE
»	$(
rüsten	VVINF
soll	VMFIN
.	$.

In	APPR
diesem	PDAT
Zusammenhang	NN
wird	VAFIN
auch	ADV
deutlich	ADJD
,	$,
dass	KOUS
die	ART
beiden	PIAT
Teile	NN
des	ART
Proömiums	NN
zusammengehören	VVFIN
:	$.
Im	APPRART
ersten	ADJA
beleuchtet	VVFIN
er	PPER
das	ART
kulturelle	ADJA
Verhältnis	NN
zwischen	APPR
Griechen	NN
und	KON
Römern	NN
,	$,
im	APPRART
zweiten	ADJA
weist	VVFIN
er	PPER
den	ART
Weg	NN
,	$,
wie	KOUS
dieses	PDAT
Verhältnis	NN
zugunsten	APPR
Roms	NE
umgekehrt	VVPP
werden	VAINF
könnte	VMFIN
.	$.

Beide	PIAT
Abschnitte	NN
stehen	VVFIN
wiederum	ADV
in	APPR
enger	ADJA
Beziehung	NN
zu	APPR
«	$(
De	NE
re	NE
publica	NE
»	$(
.	$.

