Quadro	NOM
degli	PRE:det
insediamenti	NOM
umani	ADJ
in	PRE
questo	PRO:demo
centro	NOM
della	PRE:det
media	ADJ
valle	NOM
del	PRE:det
Metauro	NOM
,	PON
dal	PRE:det
periodo	NOM
preistorico	ADJ
all'	PRE:det
età	NOM
romana	ADJ
,	PON
quando	CON
si	PRO:refl
assiste	VER:pres
alla	PRE:det
creazione	NOM
di	PRE
«	PON
Forum	NOM
Sempronii	ABR
»	PON
e	CON
di	PRE
una	DET:indef
fitta	ADJ
rete	NOM
di	PRE
insediamenti	NOM
rurali	ADJ
;	PON
in	PRE
appendice	NOM
bibliografia	NOM

