Für	APPR
die	ART
in	APPR
der	ART
Forschung	NN
umstrittene	ADJA
Frage	NN
nach	APPR
Migrationsprozessen	NN
in	APPR
Zeiten	NN
ohne	APPR
schriftliche	ADJA
Überlieferung	NN
sind	VAFIN
neben	APPR
den	ART
verschiedenen	ADJA
Modellen	NN
und	KON
historischen	ADJA
Analogien	NN
die	ART
archäologischen	ADJA
Befunde	NN
entscheidend	ADJD
.	$.

Für	APPR
die	ART
Urgeschichte	NN
Griechenlands	NE
(	$(
FH	NE
II	CARD
bis	APPR
frühe	ADJA
Eisenzeit	NN
)	$(
lässt	VVFIN
sich	PRF
annehmen	VVINF
,	$,
dass	KOUS
Wanderungen	NN
eher	ADV
regional	ADJD
erfolgten	VVFIN
und	KON
zahlenmässig	ADJD
beschränkte	ADJA
Personengruppen	NN
erfassten	VVFIN
.	$.

Durch	APPR
die	ART
Lückenhaftigkeit	NN
der	ART
Information	NN
bleiben	VVFIN
Migrationen	NN
möglicherweise	ADV
unerkannt	ADJD
.	$.

