Luca	VER:impe
vede	VER:pres
in	PRE
questo	PRO:demo
personaggio	NOM
una	DET:indef
minaccia	NOM
non	ADV
tanto	ADV
per	PRE
le	DET:def
sue	PRO:poss
pratiche	NOM
magiche	ADJ
,	PON
quanto	ADV
per	PRE
la	DET:def
sua	PRO:poss
interpretazione	NOM
mistificata	VER:pper
e	CON
deviante	NOM
degli	PRE:det
insegnamenti	NOM
di	PRE
Cristo	NOM

