Frequente	ADJ
nella	PRE:det
storia	NOM
di	PRE
Sparta	NOM
è	VER:pres
la	DET:def
contrapposizione	NOM
tra	PRE
un'	DET:indef
impostazione	NOM
etico-politica	ADJ
più	ADV
tradizionalista	NOM
e	CON
moderata	NOM
,	PON
favorevole	ADJ
alla	PRE:det
divisione	NOM
delle	PRE:det
sfere	NOM
d'	PRE
influenza	NOM
tra	PRE
i	DET:def
vari	ADJ
stati	NOM
greci	ADJ
,	PON
e	CON
un	DET:indef
atteggiamento	NOM
innovativo	ADJ
tendente	VER:ppre
all'	PRE:det
imperialismo	NOM
e	CON
all'	PRE:det
affermazione	NOM
dell'	PRE:det
egemonia	NOM
spartana	ADJ

