L'	DET:def
analisi	NOM
topografica	ADJ
del	PRE:det
santuario	NOM
evidenzia	VER:pres
le	DET:def
funzioni	NOM
sacrali	ADJ
e	CON
civili	ADJ
del	PRE:det
luogo	NOM
:	PON
in	PRE
un	DET:indef
sistema	NOM
che	PRO:rela
evitava	VER:impf
l'	DET:def
accentramento	NOM
delle	PRE:det
attivit√†	NOM
amministrative	ADJ
i	DET:def
problemi	NOM
interni	ADJ
erano	VER:impf
affrontati	VER:pper
da	PRE
magistrati	NOM
locali	ADJ
con	PRE
funzioni	NOM
religiose	ADJ
e	CON
politiche	ADJ

