Sur	PRP
les	DET:ART
débuts	NOM
de	PRP
cette	PRO:DEM
tradition	NOM
moraliste	ADJ
(	PUN
mentionnant	VER:ppre
au	PRP:det
moins	ADV
trois	NUM
vertus	NOM
cardinales	ADJ
dans	PRP
le	DET:ART
même	ADJ
contexte	NOM
)	PUN
et	KON
sa	DET:POS
diffusion	NOM
durant	PRP
le	DET:ART
haut	ADJ
Moyen	NAM
Âge	VER:pres

