Gregorio	NPR
riprende	VER:pres
il	DET:def
platonismo	NOM
plotiniano	NOM
per	PRE
negare	VER:infi
la	DET:def
preesistenza	NOM
delle	PRE:det
singole	ADJ
anime	NOM
e	CON
per	PRE
affermare	VER:infi
quella	PRO:demo
dell'	PRE:det
«	PON
Anima	NOM
del	PRE:det
Tutto	NOM
»	PON
,	PON
dalla	PRE:det
quale	PRO:rela
le	DET:def
anime	NOM
derivano	VER:pres
e	CON
alla	PRE:det
quale	PRO:rela
tendono	VER:pres

