Die	ART
Beschreibungen	NN
sind	VAFIN
nicht	PTKNEG
realitätsnah	ADJD
,	$,
sondern	KON
instrumentalisieren	VVFIN
das	ART
Verhalten	NN
der	ART
breiten	ADJA
Masse	NN
,	$,
um	KOUI
einen	ART
intellektuell	ADJD
überlegenen	ADJA
,	$,
philosophisch	ADJD
motivierten	ADJA
Umgang	NN
mit	APPR
der	ART
Katastrophe	NN
zu	PTKZU
demonstrieren	VVINF
.	$.

Die	ART
Normalreaktion	NN
ist	VAFIN
Angst	NN
,	$,
Panik	NN
,	$,
Schrecken	NN
;	$.
die	ART
meisten	PIAT
Menschen	NN
sehen	VVFIN
Naturkatastrophen	NN
als	KOKOM
Zeichen	NN
der	ART
Götter	NN
oder	KON
Strafe	NN
;	$.
rationale	ADJA
Deutungen	NN
waren	VAFIN
zu	PTKA
wenig	ADV
geeignet	ADJD
,	$,
Sicherheit	NN
zu	PTKZU
geben	VVINF
.	$.

