Il	DET:def
rapporto	NOM
di	PRE
opposizione	NOM
tra	PRE
il	DET:def
sublime	NOM
come	PRE
retorica	NOM
della	PRE:det
recitazione	NOM
e	CON
come	PRE
mimesis	NOM
letteraria	ADJ
della	PRE:det
realtà	NOM
con	PRE
il	DET:def
«	PON
sublime	ADJ
dicendi	VER:geru
genus	NOM
»	PON
vive	NOM
all'	PRE:det
interno	NOM
dei	PRE:det
complessi	ADJ
meccanismi	NOM
d'	PRE
interazione	NOM
e	CON
contaminazione	NOM
tra	PRE
retorica	NOM
di	PRE
oralità-auralità	NOM
e	CON
retorica	NOM
di	PRE
scrittura	NOM

