Se	SE
estudia	VLfin
la	ART
figura	NC
del	PDEL
poeta	NC
Rutilio	NP
Namaciano	NP
cuya	REL
obra	NC
refleja	VLfin
una	ART
temática	NC
religiosa	ADJ
netamente	ADV
pagana	VLfin
,	CM
con	PREP
influencias	VLfin
estoicas	ADJ
y	CC
neoplatónicas	ADJ
,	CM
en	PREP
una	ART
época	NC
en	PREP
la	ART
que	CQUE
el	ART
triunfo	NC
del	PDEL
cristianismo	NC
era	VEfin
muy	ADV
claro	ADJ
.	FS

