Die	ART
textlichen	ADJA
Abweichungen	NN
vor	PTKVZ
und	KON
nach	APPR
den	ART
von	APPR
POxy	NE
.	$.

15	CARD
,	$,
1787	CARD
fr.	NN
1	CARD
(	$(
fr.	NE
58	CARD
Voigt	NE
)	$(
und	KON
PKöln	NE
.	$.

Inv	NE
.	$.

21351	CARD
gemeinsam	ADJD
überlieferten	ADJA
Versen	NN
erklären	VVFIN
sich	PRF
dadurch	PAV
,	$,
dass	KOUS
vor	APPR
und	KON
nach	APPR
der	ART
gemeinsamen	ADJA
Passage	NN
,	$,
wie	KOKOM
formale	ADJA
und	KON
inhaltliche	ADJA
Beobachtungen	NN
nahelegen	VVFIN
,	$,
jeweils	ADV
unterschiedliche	ADJA
Gedichte	NN
standen	VVFIN
(	$(
wiewohl	KOUS
es	PPER
sich	PRF
bei	APPR
dem	ART
nachfolgenden	ADJA
auch	ADV
um	APPR
dasselbe	PDAT
Gedicht	NN
mit	APPR
zwei	CARD
unterschiedlichen	ADJA
Varianten	NN
des	ART
ersten	ADJA
Verses	NN
handeln	VVINF
könnte	VMFIN
)	$(
.	$.

