Report	NN
of	IN
the	DT
sixth	JJ
season	NN
of	IN
excavation	NN
carried	VBN
out	RP
by	IN
the	DT
Society	NP
for	IN
Libyan	JJ
Studies	NNS
.	SENT

New	JJ
forms	NNS
of	IN
local	JJ
black	NN
glaze	VBP
pots	NNS
were	VBD
recovered	VBN
along	RP
with	IN
fine	JJ
ware	JJ
imports	NNS
from	IN
Attica	NP
,	,
Corinth	NP
,	,
East	NP
Greece	NP
,	,
south	JJ
Italy	NP
and	CC
the	DT
Punic	JJ
world	NN
,	,
throwing	VBG
light	NN
on	IN
the	DT
interrelation	NN
between	IN
Euesperides	NP
and	CC
the	DT
Mediterranean	JJ
world	NN
from	IN
the	DT
5th-3rd	JJ
cents	NNS
.	SENT

B.	NP
C.	NP
For	IN
previous	JJ
=>	NN
75-08599	CD

