Plutarch	NP
concludes	VBZ
many	JJ
episodes	NNS
of	IN
the	DT
«	)
De	NP
mulierum	NN
virtutibus	NN
»	(
with	IN
an	DT
aetiology	NN
,	,
a	DT
device	NN
he	PP
uses	VBZ
in	IN
a	DT
sophisticated	JJ
manner	NN
.	SENT

The	DT
aetiology	NN
is	VBZ
Plutarch	NP
's	POS
main	JJ
mechanism	NN
in	IN
the	DT
work	NN
for	IN
proving	VBG
his	PP$
argument	NN
that	IN
men	NNS
and	CC
women	NNS
can	MD
display	VB
the	DT
same	JJ
virtue	NN
.	SENT

The	DT
aetiologies	NNS
legitimate	VBP
his	PP$
claim	NN
by	IN
proving	VBG
that	IN
women	NNS
's	POS
actions	NNS
had	VBD
real	JJ
consequences	NNS
.	SENT

