Examines	VBZ
verses	NNS
81-86	CD
of	IN
Martial	JJ
's	VBZ
poem	NN
,	,
which	WDT
mentions	VBZ
Deucalion	NP
and	CC
Pyrrha	NP
before	IN
enumerating	VBG
a	DT
second	JJ
«	)
catalogue	NN
of	IN
sins	NNS
»	(
,	,
focusing	VBG
on	IN
the	DT
apparent	JJ
contradiction	NN
between	IN
Martial	JJ
's	VBZ
virulent	JJ
opening	VBG
attack	NN
on	IN
mythology	NN
and	CC
his	PP$
own	JJ
recourse	NN
to	TO
mythological	JJ
themes	NNS
.	SENT

Also	RB
studies	VBZ
the	DT
intertextuality	NN
with	IN
Ovid	NP
's	POS
Metamorphoses	NP
1	CD
,	,
313-415	CD
,	,
and	CC
relations	NNS
between	IN
the	DT
genres	NNS
of	IN
satire	NN
and	CC
epic	NN
in	IN
general	JJ

