Testimonianze	NOM
letterarie	ADJ
e	CON
iconografiche	ADJ
suggeriscono	VER:pres
l'	DET:def
appartenenza	NOM
della	PRE:det
statua	NOM
ad	PRE
un	DET:indef
gruppo	NOM
di	PRE
figure	NOM
che	PRO:rela
aprivano	VER:impf
il	DET:def
corteo	NOM
di	PRE
Antonio-Dioniso	NOM
e	CON
Cleopatra-Afrodite	NOM
secondo	PRE
il	DET:def
rituale	NOM
delle	PRE:det
processioni	NOM
trionfali	ADJ
dei	PRE:det
sovrani	NOM
ellenistici	ADJ

