Cicero	NE
steht	VVFIN
mit	APPR
seinen	PPOSAT
naturrechtlichen	ADJA
Gedanken	NN
zum	APPRART
gerechten	ADJA
Krieg	NN
in	APPR
der	ART
Tradition	NN
des	ART
römischen	ADJA
Rechts	NN
und	KON
der	ART
hellenistischen	ADJA
,	$,
speziell	ADJD
der	ART
stoischen	ADJA
Philosophie	NN
.	$.

Augustinus	NE
bietet	VVFIN
paradigmatisch	ADJD
die	ART
genuin	ADJD
christlichen	ADJA
Elemente	NN
,	$,
die	PRELS
in	APPR
diese	PDAT
Tradition	NN
eingegangen	VVPP
sind	VAFIN
und	KON
die	PDS
sowohl	KON
die	ART
Idee	NN
eines	ART
«	$(
heiligen	ADJA
Krieges	NN
»	$(
als	KOKOM
auch	ADV
einen	ART
radikalen	ADJA
persönlichen	ADJA
Pazifismus	NN
ermöglichen	VVINF
.	$.

