Sull'	PRE:det
elemento	NOM
femminile	ADJ
nella	PRE:det
cultura	NOM
e	CON
nella	PRE:det
religione	NOM
antiche	ADJ
e	CON
sulla	PRE:det
figura	NOM
di	PRE
Penelope	NOM
e	CON
l'	DET:def
influsso	NOM
del	PRE:det
modello	NOM
da	PRE
essa	PRO:pers
incarnato	VER:pper
sull'	PRE:det
immagine	NOM
della	PRE:det
buona	ADJ
moglie	NOM
nel	PRE:det
mondo	NOM
antico	ADJ

