Etruscan	JJ
deviations	NNS
from	IN
Greek	JJ
archetypes	NNS
for	IN
representing	VBG
the	DT
birth	NN
of	IN
Athena	NP
exemplify	VBP
their	PP$
cultural	JJ
attitudes	NNS
toward	IN
women	NNS
and	CC
do	VBP
not	RB
devalue	VB
the	DT
Etruscan	JJ
artistic	JJ
tradition	NN
.	SENT

Rather	RB
,	,
as	IN
the	DT
result	NN
of	IN
artistic	JJ
choice	NN
,	,
Etruscan	JJ
interpretations	NNS
provide	VBP
evidence	NN
of	IN
local	JJ
mores	NN
and	CC
should	MD
therefore	RB
be	VB
recognized	VBN
as	IN
indispensable	JJ
tools	NNS
for	IN
comprehending	VBG
a	DT
largely	RB
enigmatic	JJ
society	NN
.	SENT

Evidence	NN
includes	VBZ
an	DT
Attic	JJ
black-figure	NN
kothon	NN
by	IN
the	DT
C	NP
Painter	NP
(	(
Paris	NP
,	,
Louvre	NP
CA	NP
616	CD
)	)
and	CC
a	DT
number	NN
of	IN
engraved	VBN
bronze	NN
mirrors	VBZ
from	IN
the	DT
4th-3rd	JJ
cents	NNS
.	SENT

B.	NP
C.	NP