In	APPR
Platons	NN
«	$(
Parmenides	NN
»	$(
werden	VAFIN
dem	ART
Einen	NN
im	APPRART
Sinn	NN
einer	ART
«	$(
negatio	ADJA
negationis	NN
»	$(
sowohl	KON
alle	PIAT
Eigenschaften	NN
abgesprochen	VVPP
als	KOKOM
auch	ADV
,	$,
im	APPRART
Sinn	NN
einer	ART
«	$(
coincidentia	ADJA
oppositorum	NN
»	$(
,	$,
alle	PIAT
Eigenschaften	NN
zugesprochen	VVPP
.	$.

Diese	PDS
wohl	ADV
eher	ADV
formal-ontologisch	ADJD
gemeinten	ADJA
Aussagen	NN
Platons	NN
waren	VAFIN
in	APPR
der	ART
Geschichte	NN
des	ART
Platonismus	NN
(	$(
von	APPR
Plotin	NN
bis	APPR
Nikolaus	NE
von	APPR
Kues	NN
)	$(
immer	ADV
wieder	ADV
Ausgangspunkt	NN
metaphysischer	ADJA
Spekulation	NN
.	$.

Beide	PIAT
Aussagen	NN
lassen	VVFIN
sich	PRF
im	APPRART
ontologischen	ADJA
Rahmen	NN
der	ART
antiken	ADJA
und	KON
mittelalterlichen	ADJA
Logik	NN
jeweils	ADV
so	ADV
interpretieren	VVINF
,	$,
dass	KOUS
sie	PPER
richtig	ADJD
werden	VAFIN
.	$.

Der	ART
genannte	ADJA
ontologische	ADJA
Rahmen	NN
ist	VAFIN
im	APPRART
wesentlichen	ADJA
die	ART
Boolesche	NN
Algebra	NN
der	ART
Eigenschaften	NN
erster	ADJA
Stufe	NN
.	$.

