Analisi	NOM
del	PRE:det
concetto	NOM
alla	PRE:det
luce	NOM
della	PRE:det
contrapposizione	NOM
tra	PRE
Eforo	NOM
e	CON
Platone	NPR
da	PRE
una	DET:indef
parte	NOM
e	CON
Aristotele	NPR
dall'	PRE:det
altra	ADJ
:	PON
la	DET:def
dottrina	NOM
arisotelica	ADJ
sar√†	VER:futu
ripresa	NOM
(	PON
forse	ADV
direttamente	ADV
)	PON
da	PRE
Plutarco	NOM

