Die	ART
Einschätzung	NN
,	$,
die	ART
antike	ADJA
Ethik	NN
stütze	VVFIN
sich	PRF
nicht	PTKNEG
auf	APPR
den	ART
Begriff	NN
des	ART
moralisch	ADJD
angemessenen	ADJA
,	$,
sondern	KON
auf	APPR
den	ART
des	ART
prudentiell	ADJD
vorteilhaften	ADJA
Handelns	NN
,	$,
ist	VAFIN
in	APPR
Frage	NN
zu	PTKZU
stellen	VVINF
.	$.

Vielmehr	ADV
ist	VAFIN
die	ART
wichtigste	ADJA
Traditionslinie	NN
der	ART
antiken	ADJA
Ethik	NN
(	$(
von	APPR
Platon	NE
bis	KON
zu	APPR
den	ART
spätantiken	ADJA
Platonikern	NN
)	$(
durch	APPR
eine	ART
Handlungstheorie	NN
charakterisiert	VVPP
,	$,
die	PRELS
auf	APPR
der	ART
Vorstellung	NN
beruht	VVFIN
,	$,
es	PPER
gebe	VVFIN
nicht-beliebige	ADJA
Prinzipien	NN
,	$,
welche	PRELS
das	ART
Überlegen	NN
,	$,
Wählen	NN
und	KON
Handeln	NN
eines	ART
rationalen	ADJA
Akteurs	NN
anleiten	VVINF
(	$(
sollten	VMFIN
)	$(
.	$.

Das	ART
hier	ADV
behandelte	ADJA
Modell	NN
beginnt	VVFIN
mit	APPR
einem	ART
intellektualistischen	ADJA
Willensbegriff	NN
und	KON
entwickelt	VVFIN
eine	ART
Konzeption	NN
menschlichen	ADJA
Glücks	NN
,	$,
welche	PRELS
die	ART
Grundlage	NN
für	APPR
subtile	ADJA
weitere	ADJA
Unterscheidungen	NN
zwischen	APPR
relevanten	ADJA
und	KON
nebensächlichen	ADJA
Gütern	NN
abgibt	VVFIN
.	$.

