Dall'	PRE:det
analisi	NOM
delle	PRE:det
fonti	NOM
emerge	VER:pres
un'	DET:indef
aristocrazia	NOM
affine	ADJ
,	PON
ma	CON
distinta	VER:pper
dalla	PRE:det
famiglia	NOM
reale	ADJ
,	PON
spesso	ADV
protagonista	NOM
anche	ADV
dopo	ADV
la	DET:def
caduta	NOM
dei	PRE:det
Battiadi	NOM
e	CON
nella	PRE:det
nuova	ADJ
esperienza	NOM
di	PRE
tipo	NOM
repubblicano	ADJ

