Die	ART
Beispiele	NN
machen	VVFIN
deutlich	ADJD
,	$,
dass	KOUS
die	ART
Verbreitung	NN
in	APPR
den	ART
Provinzen	NN
in	APPR
einem	ART
komplizierten	ADJA
Prozess	NN
erfolgte	VVFIN
,	$,
der	PRELS
nur	ADV
teilweise	ADV
von	APPR
Rom	NE
aus	PTKVZ
gesteuert	VVPP
wurde	VAFIN
.	$.

Die	ART
Kopien	NN
gaben	VVFIN
nicht	PTKNEG
nur	ADV
eine	ART
Vorstellung	NN
vom	APPRART
Aussehen	NN
des	ART
Princeps	NN
sondern	KON
lösten	VVFIN
zugleich	ADV
eine	ART
Anpassung	NN
der	ART
Privatporträts	NN
an	APPR
das	ART
Kaiserbildnis	NN
aus	PTKVZ
.	$.

