Die	ART
insgesamt	ADV
eher	ADV
lückenhaften	ADJA
Nachrichten	NN
ermöglichen	VVFIN
von	APPR
Christi	NE
Geburt	NN
bis	APPR
etwa	ADV
400	CARD
n.	APPR
Chr.	NE
immer	ADV
wieder	ADV
Einblicke	NN
in	APPR
die	ART
verfassungsmässigen	ADJA
Strukturen	NN
.	$.

Neben	APPR
den	ART
von	APPR
Rom	NE
eingesetzten	ADJA
oder	KON
zumindest	ADV
bestätigten	ADJA
Königen	NN
,	$,
die	PRELS
meist	ADV
nur	ADV
mit	APPR
begrenzten	ADJA
Befugnissen	NN
ausgestattet	VVPP
waren	VAFIN
,	$,
gelegentlich	ADJD
aber	KON
auch	ADV
als	KOKOM
Heerkönige	NN
auftraten	VVFIN
,	$,
gab	VVFIN
es	PPER
in	APPR
den	ART
polyethnischen	ADJA
Verbänden	NN
machtvolle	ADJA
dezentrale	ADJA
Volksversammlungen	NN

