Vor	APPR
dem	ART
Hintergrund	NN
einer	ART
Darstellung	NN
der	ART
geopolitischen	ADJA
Veränderungen	NN
Siziliens	NE
im	APPRART
Rahmen	NN
der	ART
griechischen	ADJA
Kolonisierung	NN
(	$(
auch	ADV
anhand	APPR
von	APPR
Münzen	NN
)	$(
und	KON
nach	APPR
einem	ART
Abriss	NN
zur	APPRART
Geschichte	NN
von	APPR
Leontinoi	NE
wird	VAFIN
das	ART
Fragment	NN
eines	ART
Bronzetäfelchens	NN
mit	APPR
einer	ART
Namensliste	NN
veröffentlicht	VVPP
,	$,
das	PRELS
bei	APPR
Ausgrabungen	NN
in	APPR
einem	ART
Temenos	NN
gefunden	VVPP
wurde	VAFIN
und	KON
vermutlich	ADV
zu	APPR
einer	ART
Weihgabe	NN
gehörte	VVFIN
.	$.

Dieses	PDAT
und	KON
weitere	ADJA
hier	ADV
zusammengestellte	ADJA
inschriftliche	ADJA
Zeugnisse	NN
ermöglichen	VVFIN
,	$,
eine	ART
Liste	NN
inschriftlich	ADJD
und	KON
literarisch	ADJD
bezeugter	ADJA
Leontiner	NN
aufzustellen	VVIZU

