Ancient	JJ
astrological	JJ
methodology	NN
reveals	VBZ
a	DT
distinction	NN
between	IN
two	CD
kinds	NNS
of	IN
observation	NN
claim	NN
.	SENT

Each	DT
has	VBZ
its	PP$
own	JJ
rhetorical	JJ
and	CC
theoretical	JJ
importance	NN
.	SENT

There	EX
is	VBZ
a	DT
shift	NN
in	IN
practice	NN
from	IN
observationally	RB
derived	VBN
predictions	NNS
to	TO
a	DT
reliance	NN
on	IN
textual	JJ
and	CC
instrumental	JJ
authority	NN
,	,
even	RB
though	IN
the	DT
rhetoric	NN
of	IN
ancient	JJ
astrology	NN
still	RB
tries	VBZ
to	TO
maintain	VB
an	DT
emphasis	NN
on	IN
observation	NN
.	SENT

