I	DET:def
provvedimenti	NOM
dell'	PRE:det
autorit√†	NOM
ecclesiastica	ADJ
sotto	ADV
il	DET:def
pontificato	NOM
di	PRE
Gregorio	NPR
Magno	NOM
,	PON
sia	CON
sul	PRE:det
piano	NOM
materiale	ADJ
sia	VER:cpre
su	PRE
quello	PRO:demo
dei	PRE:det
bisogni	NOM
spirituali	ADJ
,	PON
nell'	PRE:det
Italia	NPR
decimata	VER:pper
da	PRE
invasioni	NOM
,	PON
carestie	NOM
ed	CON
epidemie	NOM

