Eusebius	NE
(	$(
HE	NE
5	CARD
,	$,
21	CARD
)	$(
und	KON
die	ART
in	APPR
verschiedenen	ADJA
Versionen	NN
überlieferten	VVFIN
«	$(
Acta	NE
Apollonii	NE
»	$(
(	$(
BHG	NN
149	CARD
)	$(
berichten	VVFIN
von	APPR
dem	ART
Prozess	NN
,	$,
der	PRELS
unter	APPR
Commodus	NN
vor	APPR
dem	ART
praefectus	NN
praetorio	NE
unter	APPR
(	$(
unterschiedlich	ADJD
dargestellter	ADJA
)	$(
Beteiligung	NN
des	ART
Senats	NN
stattgefunden	VVPP
haben	VAINF
soll	VMFIN
.	$.

Eingehende	ADJA
Überlegungen	NN
zum	APPRART
Verlauf	NN
dieses	PDAT
und	KON
anderer	PIAT
Prozesse	NN
gegen	APPR
Christen	NN
machen	VVFIN
wahrscheinlich	ADJD
,	$,
dass	KOUS
bereits	ADV
Eusebius	NE
'	$(
Bericht	NN
auf	APPR
einer	ART
literarischen	ADJA
Version	NN
der	ART
Ereignisse	NN
beruht	VVPP
und	KON
dass	KOUS
insbesondere	ADV
eine	ART
Beteiligung	NN
des	ART
Senats	NN
unglaubwürdig	ADJD
ist	VAFIN
(	$(
sie	PPER
soll	VMFIN
wohl	ADV
den	ART
Kaiser	NN
von	APPR
der	ART
Schuld	NN
an	APPR
der	ART
Hinrichtung	NN
von	APPR
Christen	NN
befreien	VVINF
)	$(
.	$.

Die	ART
verbleibenden	ADJA
Nachrichten	NN
dokumentieren	VVFIN
ein	ART
einigermassen	ADV
schlüssiges	ADJA
Verfahren	NN
,	$,
das	PRELS
durchaus	ADV
historisch	ADJD
sein	VAINF
kann	VMFIN
,	$,
aber	KON
eher	ADV
als	KOKOM
Zeugnis	NN
des	ART
christlichen	ADJA
Selbstverständnisses	NN
von	APPR
Bedeutung	NN
ist	VAFIN

