Der	ART
Faun	NN
(	$(
München	NE
,	$,
Glyptothek	NE
,	$,
Inv	NE
.	$.
218	CARD
)	$(
ist	VAFIN
durch	APPR
die	ART
Felsbasis	NN
in	APPR
seine	PPOSAT
Umgebung	NN
(	$(
ursprünglich	ADJD
wohl	ADV
ein	ART
Heiligtum	NN
des	ART
Dionysos	NE
)	$(
integriert	VVPP
.	$.

Dies	PDS
,	$,
die	ART
menschenähnliche	ADJA
Gestaltung	NN
mit	APPR
zurückgenommenen	ADJA
Charakteristika	NN
des	ART
Satyrs	NN
und	KON
das	ART
Motiv	NN
des	ART
Schlafens	NN
sollen	VMFIN
eine	ART
möglichst	ADV
lebensnahe	ADJA
Begegnung	NN
mit	APPR
einem	ART
Satyr	NN
gestalten	VVINF
und	KON
die	ART
Existenz	NN
solcher	PIAT
Wesen	NN
durch	APPR
die	ART
überzeugende	ADJA
sinnliche	ADJA
Vermittlung	NN
neu	ADJD
beglaubigend	ADJD
vor	APPR
Augen	NN
führen	VVINF
.	$.

Seine	PPOSAT
Besonderheiten	NN
zeigen	VVFIN
sich	PRF
auch	ADV
im	APPRART
Vergleich	NN
mit	APPR
den	ART
späthellenistischen	ADJA
Nachfolgern	NN
,	$,
dem	ART
schnippchenschlagenden	ADJA
und	KON
dem	ART
schlafenden	ADJA
Satyr	NN
(	$(
Neapel	NE
,	$,
Museo	NN
Archeologico	NE
Nazionale	NN
,	$,
Inv	NE
.	$.
5628	CARD
und	KON
5624	CARD
)	$(
.	$.

Dem	ART
Faun	NN
am	PTKA
ehesten	ADJD
verwandt	ADJD
ist	VAFIN
der	ART
schlafende	ADJA
Eros	NN
im	APPRART
Typus	NN
New	NE
York	NE
(	$(
Metropolitan	NN
Museum	NN
,	$,
Inv	NE
.	$.
43.1.4	CARD
)	$(
.	$.

