Resoconto	NOM
dei	PRE:det
lavori	NOM
del	PRE:det
secondo	ADJ
Collegio	NOM
di	PRE
diritto	NOM
romano	ADJ
,	PON
organizzato	VER:pper
dal	PRE:det
CEDANT	NOM
a	PRE
Pavia	NPR
nel	PRE:det
gennaio	NOM
2004	NUM
e	CON
dedicato	VER:pper
al	PRE:det
tema	NOM
«	PON
Gli	VER:geru
statuti	NOM
municipali	ADJ
»	PON

