Ausgehend	ADJD
von	APPR
der	ART
Erwähnungen	NN
der	ART
«	$(
logades	NN
»	$(
(	$(
«	$(
ausgesuchte	ADJA
Männer	NN
»	$(
)	$(
bei	APPR
Priskos	NE
von	APPR
Panion	NN
(	$(
in	APPR
den	ART
«	$(
Excerpta	NN
de	NE
legationibus	NN
»	$(
zitiert	VVPP
)	$(
und	KON
bei	APPR
Jordanes	NN
werden	VAFIN
die	ART
bisherigen	ADJA
Deutungen	NN
überprüft	ADJD
und	KON
wahrscheinlich	ADJD
gemacht	VVPP
,	$,
dass	KOUS
es	PPER
sich	PRF
um	APPR
«	$(
Jugendfreunde	NN
»	$(
handelt	VVFIN
,	$,
die	ART
Attila	NN
bereits	ADV
früh	ADJD
um	APPR
sich	PRF
geschart	VVPP
hatte	VAFIN
und	KON
die	ART
nicht	PTKNEG
unwesentlich	ADJD
an	APPR
seinem	PPOSAT
Aufstieg	NN
beteiligt	VVPP
waren	VAINF
.	$.

Diese	PDAT
Art	NN
der	ART
Gefolgschaft	NN
kann	VMFIN
aus	APPR
steppennomadischer	ADJA
Traditionen	NN
erklärt	VVPP
werden	VAINF

