La	DET:def
storia	NOM
del	PRE:det
popolo	NOM
etrusco	ADJ
nell'	PRE:det
ultimo	ADJ
secolo	NOM
della	PRE:det
Repubblica	NOM
,	PON
la	DET:def
sua	PRO:poss
integrazione	NOM
nello	PRE:det
stato	NOM
romano	ADJ
e	CON
la	DET:def
sopravvivenza	NOM
della	PRE:det
«	PON
Etrusca	NOM
disciplina	NOM
»	PON
nel	PRE:det
quadro	NOM
del	PRE:det
problema	NOM
della	PRE:det
fine	NOM
del	PRE:det
«	PON
nomen	NOM
Etruscum	NOM
»	PON

