Eine	ART
Neuinterpretation	NN
der	ART
Aurei	NN
des	ART
gallischen	ADJA
Usurpators	NN
,	$,
auf	APPR
denen	PRELS
der	ART
Genius	NE
des	ART
Senats	NN
abgebildet	VVPP
ist	VAFIN
,	$,
in	APPR
Verbindung	NN
mit	APPR
zeitgleich	ADJD
geprägten	ADJA
Goldmünzen	NN
,	$,
die	PRELS
den	ART
«	$(
genius	NE
populi	NE
Romani	NN
»	$(
zeigen	VVFIN
,	$,
legt	VVFIN
nahe	PTKVZ
,	$,
dass	KOUS
Tetricus	NE
nicht	PTKNEG
nur	ADV
den	ART
senatorischen	ADJA
Adel	NN
und	KON
das	ART
römische	ADJA
Volk	NN
im	APPRART
«	$(
Gallischen	NN
Sonderreich	NN
»	$(
,	$,
sondern	KON
auch	ADV
Senat	NN
und	KON
Volk	NN
im	APPRART
Zentralreich	NN
,	$,
vor	APPR
allem	PIS
in	APPR
Rom	NE
selbst	ADV
,	$,
ansprechen	VVINF
wollte	VMFIN
und	KON
sich	PRF
als	KOKOM
Alternative	NN
zu	APPR
dem	ART
dort	ADV
anerkannten	ADJA
Aurelian	NE
anbot	VVFIN
.	$.

