Rechtsregelungen	NN
erlaubten	VVFIN
unter	APPR
speziellen	ADJA
Bedingungen	NN
die	ART
Freilassung	NN
von	APPR
Sklaven	NN
auch	ADV
durch	APPR
Minderjährige	NN
.	$.

So	ADV
ist	VAFIN
es	PPER
möglich	ADJD
,	$,
dass	KOUS
Domitius	NE
Lemnus	NE
vom	APPRART
minderjährigen	ADJA
Nero	NN
freigelassen	VVPP
wurde	VAFIN
;	$.
dies	PDS
gilt	VVFIN
vielleicht	ADV
auch	ADV
für	APPR
Phaon	NN
.	$.

Freigelassene	NN
haben	VAFIN
anscheinend	ADJD
häufig	ADJD
Nomen	NN
und	KON
Praenomen	NN
abgelegt	VVPP
,	$,
wenn	KOUS
ihr	PPOSAT
Patron	NN
beim	APPRART
Amtsantritt	NN
infolge	APPR
der	ART
Adoption	NN
durch	APPR
den	ART
Vorgänger	NN
den	ART
Namen	NN
änderte	VVFIN
.	$.

